000100000000000000R
0001010000111111100
0100101101100010100
0100010001110010101
F010000001010010100
0100111001010010100
0100101001011010100
0011101111000000100
0000000000000000000











